{
    "map_name": "L'Arène Finale",
    "width": 15,
    "height": 10,
    "spawn_point": {"x": 7, "y": 8},
    "grid": [
        [2, 2, 2, 2, 2, 2, 2, 3, 2, 2, 2, 2, 2, 2, 2],
        [2, 0, 0, 0, 0, 0, 0, 0, 0, 0, 0, 0, 0, 0, 2],
        [2, 0, 1, 1, 1, 1, 1, 1, 1, 1, 1, 1, 1, 0, 2],
        [2, 0, 1, 2, 2, 2, 2, 0, 2, 2, 2, 2, 1, 0, 2],
        [2, 0, 1, 2, 0, 0, 0, 0, 0, 0, 0, 2, 1, 0, 2],
        [2, 0, 1, 2, 0, 0, 0, 0, 0, 0, 0, 2, 1, 0, 2],
        [2, 0, 1, 2, 2, 2, 2, 0, 2, 2, 2, 2, 1, 0, 2],
        [2, 0, 1, 1, 1, 1, 1, 1, 1, 1, 1, 1, 1, 0, 2],
        [2, 0, 0, 0, 0, 0, 0, 0, 0, 0, 0, 0, 0, 0, 2],
        [2, 2, 2, 2, 2, 2, 2, 2, 2, 2, 2, 2, 2, 2, 2]
    ],
    "encounter_rate": 0.2,
    "available_enemies": ["redbull", "carbon_supercar"]
}
